NO ./asset/B1.xpm
SO ./asset/CapyAD5.xpm
WE ./asset/DB.xpm
EA ./asset/Dungeon_Bricks1.xpm

F 220,100,0
C 225,30,0

11111111
11001001
10000101
10000001
1000N001
10000001
10001001
11111111