NO ./asset/B1.xpm
SO ./asset/CapyAD5.xpm
WE ./asset/DB.xpm
EA ./asset/Dungeon_Bricks1.xpm

F 220,100,0
C 225,30,0

111111111111
100000000001
100000000001
1000000N0001
100000000001
100111000001
100000000001
111111111111
