NO ./asset/W1.xpm
SO ./asset/W2.xpm
WE ./asset/W3.xpm
EA ./asset/W4.xpm
D ./asset/door.xpm

F 220,100,0
C 225,30,0

        1111111111111111111111111
        1000000000110000000000001
        10110000011100000000X0001
        1001000000P00000000000001
111111111011000001110000000000001
1000000000110000011101P111P111111
11110111111111011100000010001
1111P111111111011P01010010001
11000000110101011100000010001
10000000000000001100000010001
10000000000000001101010010001
11000001110101011111011110N0111
11110111 1110101 101111010001
11111111 1111111 111111111111
